1 1 1 1 6 6 1 1 1 1
1 0 0 0 1 1 0 0 0 1
5 5 5 5 5 5 5 5 5 5
6 4 4 4 4 4 4 4 4 6
3 3 3 3 6 6 3 3 3 3
2 2 2 2 2 2 2 2 2 2
1 1 1 1 1 1 1 1 1 1