0 0 0 0 0 0 0 0 0 0
0 0 0 0 0 0 0 0 0 0
6 2 3 4 1 2 3 4 1 2
2 3 4 6 2 3 4 1 2 3
3 4 1 2 3 4 6 2 3 4
4 1 2 3 4 1 2 3 4 6