0 1 0 0 1 1 0 0 1 0
5 5 5 5 5 5 5 5 5 5
2 4 1 3 6 4 3 1 4 2
1 3 2 4 1 2 3 4 6 1
4 6 3 1 4 3 2 1 3 4
2 1 4 3 1 6 4 3 2 1