0 0 5 0 0 0 0 0 0 0
0 5 1 5 0 0 0 0 0 0
0 0 5 0 0 0 0 0 0 0
0 0 0 0 0 0 0 0 0 0
0 0 0 0 0 0 0 5 0 0
0 3 3 3 0 0 5 1 5 0
0 3 6 3 0 0 0 5 0 0
0 3 3 3 0 0 0 0 0 0
0 0 0 0 0 0 0 0 0 0
0 0 0 0 0 0 3 3 3 0
0 0 0 0 0 0 3 6 3 0
0 0 0 0 0 0 3 3 3 0
