0 0 0 0 5 5 0 0 0 0
6 6 6 6 5 5 0 0 0 0
0 0 0 0 5 5 6 6 6 6
0 0 0 0 5 5 0 0 0 0
0 0 0 0 5 5 5 3 3 5
0 0 0 0 5 5 2 2 2 2
0 0 0 0 5 5 2 2 2 2
5 3 3 5 5 5 1 1 1 1
2 2 2 2 5 5 0 0 0 0
2 2 2 2 5 5 0 0 0 0
1 1 1 1 5 5 0 0 0 0
0 0 0 0 5 5 0 0 0 0
0 0 0 0 5 5 0 0 0 0
0 0 0 0 5 5 0 0 0 0
0 0 0 0 5 5 0 0 0 0

